#####4#####
###44444###
#223333322#
11122222111
11111111111