##1234321##
##3444443##
#223333322#
11122222111
11111111111